..............i...............
..............................
...................&..........
....^...8.......*.............
....6.....8...................
..*................b....*.....
.........*....................
....*.............4...^^^.....
......................^^......
..................t..^.*......
......&..........9............
..............................
....^........8........&.......
..............................

