~~~~~ASCIIMAP-GAME-PLAYER~~~~~
..............................
....__^._......._.....*.....^.
.....^.*......._...._.._......
..^_..._*.***..._.............
...^^_*.........^._......*...^
.*.__..._*._*.......*....*^^..
...._..._.._*.._..*.._.^...^._
..^....^..*..*..^^__._^...^.^.
.^._.._^^.*.^_._^*.^_^.....*..
*^..*_..^._........^._.__._...
_..*.._..^^.^*..^^.^..._.._..^
....._.^_^..^..^*.^.....*.....
...^^_.....^.^_.._.^^....^.^..
